########B#
#   # #  #
### # ## #
# # #    #
# #   ## #
# ### #  #
#   # ## #
### # #  #
# #   #  #
#A####### 